12,13,13,14,15,15,16
6,7,8,9,10,11,12,13,14,14
8,9,9,9,10,11,12,13,13,14,15
2,3,4,5,5
12,13,14,15,16,17,17,17,18,19,19,19,20
14,15,15,16,17,18,19,20,20,21,21,22,22
6,7,8,8,9,10,10,10,11,12,13,14,15
7,8,8,8,9,10,11,12,13
13,14,15,15,16,16,17,18,19,20
11,12,13,14,15
13,14,15,16,17,18,19,20,20,21
15,16,17,17,17,17,17,18,18,19,20,21,22,23
2,2,2,2,2
11,11,11,12,13,14,15,16,17,17,18
1,1,1,2,2,3,3,4,4
1,2,3,4
15,16,17,18,19,19,19,20,21,22
14,14,15,16,17,18,19,20,21,22,22
8,9,10,10,10,10,10,11,12,13,14,14,15,16
5,5,6,7,7,8,9,9,9,10,11,12,13